# Map Level 5
########
## P ###
## #B  #
# AG G #
#  BB ##
### #G##
###   ##
########

1,3
