# Map Level 4
##############
#GG  #     ###
#GG  # B  B  #
#GG  #B####  #
#GG    P ##  #
#GG  # #  B ##
###### ##B B #
### B  B B B #
###    #     #
##############


4,7
