# Map Level 2
#######
#     #
#PB B #
# G#G #
#  #  #
#  #  #
#######

2,1
