# Map Level 2
########
###   ##
#GPB  ##
### BG##
#G##B ##
# # G ##
#B ABBG#
#   G  #
########

2,2
