# Map Level 1
#####
#P  #
# B #
#  G#
#####

1,1
